000000000000000000000000000000000000000000000000000000000000
000000000000000000000000000000000000000000000000000000000000
000000000000000000000000000000000000000000000000000000000000
000220000c00000000000000000000000000000000000000000000000000
000000022222000000000000000000000000022222000000000000000000
0m000000000000220000000000c0000m0020000000002200m0000000c000
220c00v00000T0000220000v022000220c00v00000T0000220000v022000
112222222222222221100j02211200112222222222222221100002211200
111111111111111111100001111100111111111111111111100001111100
111111111111111111100000110000111111111111111111100000110000
111111111111111111100000100000111111111111111111100000100000
111111111111111111100000100000111111111111111111100000100000
111111111111111111100000100000111111111111111111100000100000