000000000000000000000000000000000000000000000000000000000000000121200000000000000000000000000000
0000000000000000m0000000000v000000000000000000000000000v1210000000000000000000c0H000000000000000
00000000000F212121000c0000212000000000000000c00000001212333000000000F000T0012121200000000000000P
v0000000c0013333330002120000000000c000000T0021212000333333300000000021212000000000000000000F1212
100000000000333333000000000000000F000212120000000000333333300000000000000000000000T0000002123333
300000121000333330000000000000021200000000000000000033333300000000000000000000000021210003333333
3200000000H0333330000000000000000000000000000000000033333000000000000000000000000000000000333333
331212121212333330000000000000000000000000000000000003333000000000000000000000000000000000033333
333333333333333330000000000000000000000000000000000003333300000000000000000000000000000000033333
333333333333333330000000000000000000000000000000000000000000000000000000000000000000000000003333
333333333333333330000000000000000000000000000000000000000000000000000000000000000000000000033333
333333333333333330000000000000000000000000000000000000000000000000000000000000000000000000033333
333333333333333330000000000000000000000000000000000000000000000000000000000000000000000000033333
333333333333333330000000000000000000000000000000000000000000000000000000000000000000000000033333
333333333333333330000000000000000000000000000000000000000000000000000000000000000000000000033333
333333333333333330000000000000000000000000000000000000000000000000000000000000000000000000033333
333333333333333330000000000000000000000000000000000000000000000000000000000000000000000000033333
333333333333333330000000000000000000000000000000000000000000000000000000000000000000000000033333
333333333333333330000000000000000000000000000000000000000000000000000000000000000000000000033333