000000000000000000000000000000000000000000000000000000000000
000000000000000000000000000000000000000000000000000000000000
000000000000000000000000000000000000000000000000000000000000
000220000c00000000000000000000000000000000000000000000000000
100000021212000000000000000000000000021212000000000000000000
3m000000000000120000000000c0000m0020000000001200m0000000P000
310c00v00000T0000210000v022000220c00v00000T0000220000v022000
331212121212121213300j02233200331212121212121213300002233200
333333333333333333300003333300333333333333333333300003333300
333333333333333333300000330000333333333333333333300000330000
333333333333333333300000300000333333333333333333300000300000
333333333333333333300000300000333333333333333333300000300000
333333333333333333300000300000333333333333333333300000300000