000000000000000000000000000000000000000000000000000000000000000000000000000000000000000000000000
00000000000000000c000000000000000000000000000000000000000000000000000000000000000mc0000000000000
00000000000000000000000000000000000000000000000000c000000000000000000000000000001212000000000000
v00000000000000G0T0v000000000000000000000000F00000000000v0000000000000000000T2123333000000000000
100000000G00T002121200T0H000000000000000002120000G0000021200000000000000H0121333333300000c000000
3200000002121000000000212100000c0000G001000000000212000000000000000000T2123333333333TTT000000000
33m000cF000000000000000000000F000m00200000000000000000000000000000m01213333333333333121000000000
33121212000000000000000000002121210000000000000000000000000000c0021233333333333333333330H000P00v
333333330000000000000000000v33333300000000000000000000000000002123333333333333333333333212121212
333333330000000000000000000233333300000000000000000000000000003333333333333333333333333333333333
333333330000000000000000000333333300000000000000000000000000003333333333333333333333333333333333
333333330000000000000000000333333300000000000000000000000000003333333333333333333333333333333333
333333330000000000000000000333333300000000000000000000000000003333333333333333333333333333333333
333333330000000000000000000333333300000000000000000000000000003333333333333333333333333333333333
333333330000000000000000000333333300000000000000000000000000003333333333333333333333333333333333
333333330000000000000000000333333300000000000000000000000000003333333333333333333333333333333333
333333330000000000000000000333333300000000000000000000000000003333333333333333333333333333333333
333333330000000000000000000333333300000000000000000000000000003333333333333333333333333333333333
333333330000000000000000000333333300000000000000000000000000003333333333333333333333333333333333