000000000000000000000000000000000000000000000000000000000000000000000000000000000000000000000000
000000000000000000000000000000000000000000000000000000T00000000000000000000000000T00P000000G0000
000000000000000c000000000000000000000000000000000000002120000121000H000000000c012121212121212000
20000000000000000000000000000000T0000000000000000000000000v00000002120000m0T21233333333333333000
3v000000000H000000000000G0c0021210000000000m0000000000000021200000000000021233333333333333333000
310000000001210000000T01212000000000000000012100000000000000000000000000033333333333333333333000
3300v000c000000000212100000000000TT000V000000000T00000212000002120000c00033333333333333333333000
332121212000000000000000000000000212121210000000121000000000000000012100033333333333333333333000
333333333000000000000000000000000333333330000000000000000000000000000000033333333333333333333000
333333333000000000000000000000000333333330000000000000000000000000000000033333333333333333333000
333333333000000000000000000000000333333330000000000000000000000000000000033333333333333333333000
333333333000000000000000000000000333333330000000000000000000000000000000033333333333333333333000
333333333000000000000000000000000333333330000000000000000000000000000000033333333333333333333000
333333333000000000000000000000000333333330000000000000000000000000000000033333333333333333333000
333333333000000000000000000000000333333330000000000000000000000000000000033333333333333333333000
333333333000000000000000000000000333333330000000000000000000000000000000033333333333333333333000
333333333000000000000000000000000333333330000000000000000000000000000000033333333333333333333000
333333333000000000000000000000000333333330000000000000000000000000000000033333333333333333333000
333333333000000000000000000000000333333330000000000000000000000000000000033333333333333333333000